[
  898, 0, 0, 0, 0, 1040, 1044, 898, 898, 898, 898, 898, 898, 1035, 898, 1045, 1041, 0, 0, 898, 898, 898, 898, 898, 898,
  0, 0, 0, 0, 0, 1039, 0, 0, 0, 0, 898, 898, 0, 0, 0, 0, 1043, 0, 1034, 1038, 1042, 0, 898, 898, 0, 0, 0, 0, 0, 0, 0, 0,
  0, 0, 898, 898, 0, 0, 0, 0, 0, 0, 0, 0, 0, 0, 898, 898, 0, 0, 0, 0, 0, 0, 0, 0, 0, 0, 898, 898, 898, 898, 898, 898, 0,
  0, 898, 898, 898, 898, 898, 898, 0, 1037, 0, 0, 0, 0, 0, 0, 0, 0, 898, 898, 0, 0, 0, 0, 0, 0, 0, 0, 0, 0, 898, 898, 0,
  0, 1036, 0, 0, 0, 0, 1032, 0, 0, 898, 898, 0, 0, 0, 0, 0, 0, 0, 0, 0, 0, 898, 898, 898, 898, 898, 898, 896, 896, 898,
  898, 898, 898, 898
]
